111111111111111
1E1C00000000001
10111101001C001
100001001010101
100000000000001
111111111C00001
1P0000000000001
111111111111111
