11111111111111
1CE000000000C1
11111000011111
1C0000000000C1
11111000011111
1C0000000000C1
11111000011111
1C0000000000C1
11111000011111
1P0000000000C1
11111111111111
