1111111111111111111111111
100010001C00100010001EC11
1C10001000100010001000011
1011111111111111111111111
1010001C0010001C001C00111
100C100010001C00100010001
1111111111111111111111101
1P10001C0010001C001C00101
100C100010001C00100010001
1111111111111111111111111
