111111111111111111111111
1P000000C000000000000C01
101111111111111111111101
1E000000C000000000000C01
111111111111111111111111
