1111111111111111111111111111111111111111111111111111111111111
1000000000000000000000000000000000000000000000000000000000011
1000000000000000000000000000000000000000000000000000000000011
1000000000000000000000000000000000000000000000000000000000011
1000000000000000000000000000000000000000000000000000000000011
1000000000000000000000000000000000000000000000000000000000011
1000000000000000000000000000000000000000000000000000000000011
1000000000000000000000000000000000000000000000000000000000011
1000000000000000000000000000000000000000000000000000000000011
1000000000000000000000000000000000000000000000000000000000011
1000000000000000000000000000000000000000000000000000000000011
1000000000000000000000000000000000000000000000000000000000011
1000000000000000000000000000000000000000000000000000000000011
1000000000000000000000000000000000000000000000000000000000011
1000000000000000000000000000000000000000000000000000000000011
1000000000000000000000000000000000000000000000000000000000011
1000000000000000000000000000000000000000000000000000000000011
1000000000000000000000000000000000000000000000000000000000011
1000000000000000000000000000000000000000000000000000000000011
1000000000000000000000000000000000000000000000000000000000011
1000000000000000000000000000000000000000000000000000000000011
1000000000000000000000000000000000000000000000000000000000011
1000000000000000000000000000000000000000000000000000000000011
1000000000000000000000000000000000000000000000000000000000011
1000000000000000000000000000000000000000000000000000000000011
1000000000000000000000000000000000000000000000000000000000011
1000000000000000000000000000000000000000000000000000000000011
1000000000000000000000000000000000000000000000000000000000011
1000000000000000000000000000000000000000000000000000000000011
1PCE000000000000000000000000000000000000000000000000000000011
1111111111111111111111111111111111111111111111111111111111111
