11111111111111111111111111111111111
10001111100000000000000000001111111
10000111110000001110000001110P11001
10000011111000001110000001111111001
10010001111100000000000000100000001
100100000001001CPE00000000010000001
10011111100100001100000000000000001
10000000100100000000000000000000001
10000000100100000000000000000000001
10001111111100000000000000000000001
10000000000000000000000000100000001
10000000000000000000000000100000001
11111111110000000000000000100000001
10000000010000000000000000100000001
10000000010000000000000000100000001
100000001100C0000000000000100000001
1000C0000100C00000000000001000C0001
10000000110000000000000000100000001
10000001111000000000000000100000001
10000011111100000000000000100000001
10111111111110000000000010101010111
1000C0000CC000000000000010101010101
10000000000000000000000010101010101
11111111111111111111111111111111111
