11111111111111111111111
1P000000C00000000000C01
11111111111111111111111
1E000000000000000000C01
11111111111111111111111
