11111111111111111111111111111111111111111111111111111
10000000000000000000000000000000010000000100000000001
10000000000000000000000000100000010000000100000000001
1P000000000000000000000000100000010000000100001000001
10000000000000000000000000100000010000000100001000001
10000000000000000000000000100000010C00000100001111111
10000000000000000000000000100000010000000100001000001
10E000000000000000000000001000000100000001000010C0001
10000000000000000000000000100000010000000100001000001
100C0000000000000000000000100000000000000100001000001
11111111111111111111111111111111111111111111111111111
