11111111111111111111111111111111111
10000000000000000000000000000000001
10sabrifer0000000000000000000000001
10000000000000000000000000000000001
10000000000000000000000000000000001
100000000000001CPED0000000000000001
100000000000000CCCCCC00000000000001
100000000000000CCCCCC00000000000001
100000CCCCCCCCCCCCCCCCCCCC000000001
1000000000000000CCCCCC0000000000001
10000000000000000000000000000000001
10000000000CCCCCCCCCCCC000000000001
10000000000000000000000000000000001
10000000000000000000000000000000001
10000000000000000000000000000000001
10000000000000000000000000000000001
10000000000000000000000000000000001
10000000000000000000000000000000001
10000000000000000000000000000000001
10000000000000000000000000000000001
10000000000000000000000000000000001
10000000000000000000000000000000001
10000000000000000000000000000000001
11111111111111111111111111111111111
