11111111111111111111111111111111111
10000000000000000000000000000000001
10000000000000111110000000000000001
10000000000000000000000000000000001
10000000000000000000000000000000001
10000000000000000111111110000000001
10000000000000000000001110000000001
10000000000000000000001110000000001
10000000000001111110001110000000001
10000000000000000011111110000000001
10000000000000000011000000000000001
10000000000000001111000E00000000001
10000000000000011110000000000000001
1000P000000000000111000000000000001
10000111111111111110000000000000001
10000000000000000000000000000000001
10000000000000000000000000000000001
10000000000000000000000000000000001
10000000000000000000000000000000001
10000000000000000000000000000000001
10000000111111111110000000000000001
10000000000000000000000000000000001
10000000000000000000000000000000001
11111111111111111111111111111111111
