11111111111111111111111111111111111
10000000000000000000000000000000001
100000000000000CCC00000000000000001
10000000000000000000000000000000001
11111111110011111111001111111111111
10000000000000100010000000000000001
100000000000001C0E10000000000000001
10000000000000101110000000000000001
10000000000000100000000000000000001
11111111111111111111111111111111111
